R 1024 800
NO ./512-4.xpm
SO ./512-3.xpm
F 122,122,122
EA ./512-2.xpm
WE ./512-1.xpm 
S ./barrel.xpm
C 255,200,160

1111111111111
1W00000020001
1110000000001
1000000020001
1110020000011
1002000010001
1111111111111